0000000000
0000100000
0001110000
0111111000
0111111110
0111111110
0011111100
0001111000
0000100000
0000000000